11111111
10000001
100a0001
10000001
11111111
