11111111111111111
1000P001000000001
10000001000000001
100C00010000N0001
11111001001111111
100000C0000000001
1000000000000N0E1
11111111111111111
