11111111111111111
1000P001000000001
10C00001000000001
10000001000000001
11111001001111111
10000000000000001
10000C000000000E1
11111111111111111
