11111111111111111
1000P001000000001
10000001000000001
10000001000000001
11111111111111111
10000000000C00001
100C0000000000001
11111111111111111
