11111111111111111
1000P00100000E1N1
10000001000N01101
100C00010N0000001
11111001010000001
1000N0C00100000N1
100000N00100000E1
11111111111111111
