1111111111111
1000P00C000E1
1111111111111